11:33


.......................BBBBBBBBBB
................BBBBBBB..SSS.....
..............B..SS.............E
........BBBBBB.......e........B.E
.......B..SS.......BBBBBBB*BBBBBB
BBBBBBB...........B.......B......
....SS.....e.....B...............
........BBBBBBBBB................
.......B.........................
P*BBBBB..........................
GGGGGGG..........................