20 210
..................................................................................................................................................................................................................
..................................................................................................................................................................................................................
..................................................................................................................................................................................................................
..................................................................................................................................................................................................................
..................................................................................................................................................................................................................
..................................................................................................................................................................................................................
..................................................................................................................................................................................................................
..................................................................................................................................................................................................................
..................................................................................................................................................................................................................
..................................................................................................................................................................................................................
..................................................................................................................................................................................................................
..................................................................................................................................................................................................................
..................................................................................................................................................................................................................
..................................................................................................................................................................................................................
..................................................................................................................................................................................................................
..................................................................................................................................................................................................................
..................................................................................................................................................................................................................
..................................................................................................................................................................................................................
......................................................................................................P...........................................................................................................
GGGGGGGGGGGGGGGGGGGGGGGGGGGGGGGGGGGGGGGGGGGGGGGGGGGGGGGGGGGGGGGGGGGGGGGGGGGGGGGGGGGGGGGGGGGGGGGGGGGGGGGGGGGGGGGGGGGGGGGGGGGGGGGGGGGGGGGGGGGGGGGGGGGGGGGGGGGGGGGGGGGGGGGGGGGGGGGGGGGGGGGGGGGGGGGGGGGGGGGGGGGGGGGGGG