11:35
...................................
...................................
...................................
...................................
...................................
.HBB.BBB.BBB...........BB........EE
.HBB...........B.......SS........EE
.HBB............B...BB......B....BB
.HBB............................BBB
PHBB^^^^^^^^^^^^^^^^^^^BB^^^^^^^BBB
GGGGGGGGGGGGGGGGGGGGGGGGGGGGGGGGGGG