20 69
.....................................................................
.....................................................................
.....................................................................
..............B..........................B...........................
..............B............................B.........................
............BBB..BB...BBB.BBB..BBBB..BB..BBBB..BB....................
...........B..B.B..B.B....B..B....B.B..B.B.B..B..B...................
...........B..B.BBBB..BB..B..B..BBB.B....B.B..B..B...................
...........B..B.B.......B.B..B.B..B.B..B.B.B..B..B...................
............BBB..BBB.BBB..BBB..BBBB..BB..B.BB..BB....................
..........................B..........................................
..........................B.........................................E
....................................................................E
....................................................................E
....................................................................E
....................................................................E
....................................................................E
.....e..........P................e..................................E
GGGGGGGGGGGGGGGGGGGGGGGGGGGGGGGGGGGGGGGGGGGGGGGGGGGGGGGGGGGGGGGGGGGGG